11111111
11000001
1P1C0001
11000001
10000001
11111111