111111
1P0E01
110001
100001
110C01
100001
111111