111111111111111111111
100000000000000000001
100000000000000000001
100000000000000000001
100000000C00000000001
100000000000000000001
1000P0000000000000001
100000000000000000001
100000000000000000001
100000000000000000001
1000000C000000E000001
100000000000000000001
1CCCCCCCCCCCCCCCCCCC1
111111111111111111111